ぁ=la
あ=a
ぃ=li
い=i
いぇ=ye
ぅ=lu
う=u
うぁ=wha
うぃ=whi
うぇ=whe
うぉ=who
ぇ=le
え=e
ぉ=lo
お=o
か=ka
が=ga
き=ki
きぃ=kyi
きぇ=kye
きゃ=kya
きゅ=kyu
きょ=kyo
ぎ=gi
ぎぃ=gyi
ぎぇ=gye
ぎゃ=gya
ぎゅ=gyu
ぎょ=gyo
く=ku
くぁ=qwa
くぃ=qwi
くぅ=qwu
くぇ=qwe
くぉ=qwo
くゃ=qya
くゅ=qyu
くょ=qyo
ぐ=gu
ぐぁ=gwa
ぐぃ=gwi
ぐぅ=gwu
ぐぇ=gwe
ぐぉ=gwo
け=ke
げ=ge
こ=ko
ご=go
さ=sa
ざ=za
し=shi
しぃ=syi
しぇ=she
しゃ=sha
しゅ=shu
しょ=sho
じ=ji
じぃ=jyi
じぇ=je
じゃ=ja
じゅ=ju
じょ=jo
す=su
すぁ=swa
すぃ=swi
すぅ=swu
すぇ=swe
すぉ=swo
ず=zu
せ=se
ぜ=ze
そ=so
ぞ=zo
た=ta
だ=da
ち=chi
ちぃ=cyi
ちぇ=che
ちゃ=cha
ちゅ=chu
ちょ=cho
ぢ=di
ぢぃ=dyi
ぢぇ=dye
ぢゃ=dya
ぢゅ=dyu
ぢょ=dyo
っ=ltsu
つ=tsu
つぁ=tsa
つぃ=tsi
つぇ=tse
つぉ=tso
づ=dzu
て=te
てぃ=thi
てぇ=the
てゃ=tha
てゅ=thu
てょ=tho
で=de
でぃ=dhi
でぇ=dhe
でゃ=dha
でゅ=dhu
でょ=dho
と=to
とぁ=twa
とぃ=twi
とぅ=twu
とぇ=twe
とぉ=two
ど=do
どぁ=dwa
どぃ=dwi
どぅ=dwu
どぇ=dwe
どぉ=dwo
な=na
に=ni
にぃ=nyi
にぇ=nye
にゃ=nya
にゅ=nyu
にょ=nyo
ぬ=nu
ね=ne
の=no
は=ha
ば=ba
ぱ=pa
ひ=hi
ひぃ=hyi
ひぇ=hye
ひゃ=hya
ひゅ=hyu
ひょ=hyo
び=bi
びぃ=byi
びぇ=bye
びゃ=bya
びゅ=byu
びょ=byo
ぴ=pi
ぴぃ=pyi
ぴぇ=pye
ぴゃ=pya
ぴゅ=pyu
ぴょ=pyo
ふ=fu
ふぁ=fwa
ふぃ=fwi
ふぅ=fwu
ふぇ=fwe
ふぉ=fwo
ふゃ=fya
ふゅ=fyu
ふょ=fyo
ぶ=bu
ぷ=pu
へ=he
べ=be
ぺ=pe
ほ=ho
ぼ=bo
ぽ=po
ま=ma
み=mi
みぃ=myi
みぇ=mye
みゃ=mya
みゅ=myu
みょ=myo
む=mu
め=me
も=mo
ゃ=lya
や=ya
ゅ=lyu
ゆ=yu
ょ=lyo
よ=yo
ら=ra
り=ri
りぃ=ryi
りぇ=rye
りゃ=rya
りゅ=ryu
りょ=ryo
る=ru
れ=re
ろ=ro
ゎ=lwa
わ=wa
を=wo
ん=n
ヴ=vu
ヴぁ=va
ヴぃ=vi
ヴぇ=ve
ヴぉ=vo
ヴゃ=vya
ヴゅ=vyu
ヴょ=vyo
ヵ=lka
ヶ=lke
ー=-
